##...#####
......#...
...####...
.#...##...
.......@..
...##.....
#......###
######...#
....#....#
##.......#