.###.###..
#...#...#.
#...@...#.
.#.....#..
..#...#...
...#.#....
....#.....
..........
..........
..........